#################################
#.....##.......................##
#.....#.........................#
#.....#.........................#
#...............................#
#...............................#
#...............................#
#...............................#
#...............................#
#...........####................#
#...........####................#
#.....#.........................#
#.....###.......................#
#################################